{
  "levels": [
    {
      "grid": [
        [1, 1, 1, 1, 1, 1, 1, 1],
        [1, 2, 0, 0, 0, 0, 0, 1],
        [1, 0, 1, 1, 0, 1, 0, 1],
        [1, 0, 1, 0, 0, 0, 3, 1],
        [1, 1, 1, 1, 1, 1, 1, 1]
      ],
      "theme": "#4a90e2"
    },
    {
      "grid": [
        [1, 1, 1, 1, 1, 1, 1, 1],
        [1, 2, 0, 1, 0, 1, 0, 1],
        [1, 0, 0, 0, 0, 0, 0, 1],
        [1, 1, 0, 1, 1, 1, 3, 1],
        [1, 1, 1, 1, 1, 1, 1, 1]
      ],
      "theme": "#e74c3c"
    }
  ]
}

